,symbol,Total buyers,Total sellers,Total traders,Min total traders,Total units,Max units per trader,Min units per trader,Normalized max units per trader,stddev,Optimal buyers,Optimal sellers,Optimal units,Optimal gain,MUDA-lottery gain,MUDA-Vickrey traders gain,MUDA-Vickrey total gain
0,IBM,3,7,10,3,80945,78500,100,785.0,78509.62377314006,2,9,2000,125.0,0,0,0
1,IBM,3,17,20,3,16884,10444,100,104.44,10823.942719730181,0,0,0,0.0,0,0,0
2,IBM,5,25,30,5,33566,13213,100,132.13,15297.443446537072,0,0,0,0.0,0,0,0
3,IBM,8,32,40,8,132818,98678,100,986.78,99514.62992947319,0,0,0,0.0,0,0,0
4,IBM,11,39,50,11,49103,13213,100,132.13,16142.807035952575,0,0,0,0.0,0,0,0
5,IBM,16,44,60,16,198544,78500,100,785.0,111356.2500446203,18,19,17000,13426.0,6184.375,2762.5,6375.0
6,IBM,14,56,70,14,768176,98678,100,986.78,259321.68133035078,68,65,90000,146050.0,130375.0,121562.5,134350.0
7,IBM,14,66,80,14,126791,78500,100,785.0,79145.17575316894,9,17,8500,6928.5,0,0,0
8,IBM,26,64,90,26,321669,78500,100,785.0,137953.00210216522,13,40,11237,9975.625,6674.0,2836.75,6943.75
9,IBM,21,79,100,21,240287,98678,100,986.78,126849.83357103785,22,21,27300,44028.0,36475.0,36475.0,36475.0
10,IBM,21,89,110,21,525745,98678,100,986.78,199820.8265046464,0,0,0,0.0,0,0,0
11,IBM,19,101,120,19,400532,98678,100,986.78,162395.95473410044,24,26,36000,50350.0,0,0,0
12,IBM,20,110,130,20,859973,98678,100,986.78,273212.07113705645,29,51,51100,66950.0,0,0,0
13,IBM,30,110,140,30,487686,98678,100,986.78,180943.7114574585,44,40,54600,88056.0,86780.0,86780.0,86780.0
14,IBM,33,117,150,33,502753,98678,100,986.78,180692.84106184173,44,40,54600,88056.0,12006.25,8000.0,25275.0
15,IBM,37,123,160,37,509571,98678,100,986.78,180410.94094594152,44,40,54600,88056.0,86780.0,86780.0,86780.0
16,IBM,32,138,170,32,417937,98678,100,986.78,162241.0332468331,24,26,36000,50350.0,0,0,0
17,IBM,48,132,180,48,376664,98678,100,986.78,149569.89053950665,34,29,41374,66965.0,4621.875,9687.5,13762.5
18,IBM,41,149,190,41,1045456,98678,100,986.78,289065.65023883415,88,80,109200,191250.0,0,0,0
19,IBM,38,162,200,38,519607,98678,100,986.78,170872.85272681556,39,36,47400,85146.0,24162.5,21925.25,24337.5
20,IBM,48,162,210,48,614935,98678,100,986.78,188086.78814579188,52,53,63200,99852.75,0,0,0
21,IBM,41,179,220,41,407267,98678,100,986.78,143839.77567766156,0,0,0,0.0,0,0,0
22,IBM,42,188,230,42,905887,98678,100,986.78,247138.77001191053,101,87,124122,181020.0,98510.75,62982.0,133250.0
23,IBM,42,198,240,42,684169,98678,100,986.78,207072.6643403228,44,40,54600,95625.0,0,0,0
24,IBM,53,197,250,53,1075516,98678,100,986.78,277814.8788276107,132,116,163800,228110.0,85850.0,38712.5,112537.5
25,IBM,50,210,260,50,931565,98678,100,986.78,252126.56625393525,91,79,110600,185967.0,3468.75,525.0,12525.0
26,IBM,76,194,270,76,907347,98678,100,986.78,253832.51230880572,88,80,109200,176112.0,105594.5,76975.0,127525.0
27,IBM,58,222,280,58,1507274,98678,100,986.78,330992.5884759355,176,154,218400,322290.0,235492.0,203391.0,282765.0
28,IBM,60,230,290,60,557380,98678,100,986.78,165623.23735514894,24,26,36000,50350.0,36475.0,22675.0,39975.0
29,IBM,68,232,300,68,1827708,98678,100,986.78,372599.02916942764,176,160,218400,360750.0,96475.0,39125.0,147200.0
30,IBM,62,248,310,62,765622,98678,100,986.78,191966.05946885506,52,53,63200,100085.75,41458.0,36428.5,44875.0
31,IBM,62,258,320,62,985996,98678,100,986.78,257917.27111226963,29,48,51100,64675.0,0,0,0
32,IBM,68,262,330,68,1195753,98678,100,986.78,282435.0418821999,116,96,137622,238360.25,150067.25,89016.5,182538.5
33,IBM,80,260,340,80,1296343,98678,100,986.78,295750.5151728396,132,118,163800,251580.0,197389.5,169729.0,226495.0
34,IBM,81,269,350,81,1083172,98678,100,986.78,273274.25745942484,88,80,109200,184000.0,83386.75,40375.0,111312.5
35,IBM,72,288,360,72,1413813,98678,100,986.78,317786.7641375267,110,100,136500,235437.5,80225.0,29737.5,96162.5
36,IBM,86,284,370,86,1253970,98678,100,986.78,291564.519772211,88,80,109200,191250.0,98257.0,72637.5,128587.5
37,IBM,90,290,380,90,1517683,98678,100,986.78,317015.1696354608,167,145,206870,295075.0,180977.5,123856.0,232622.0
38,IBM,72,318,390,72,958905,98678,100,986.78,242611.8728112868,66,60,81900,139812.5,128676.5,128132.0,134000.0
39,IBM,99,301,400,99,1376640,98678,100,986.78,308238.92105637793,92,91,126000,196400.0,0,0,0
40,IBM,87,323,410,87,925627,98678,100,986.78,222534.53725433274,66,60,81900,132084.0,0,0,0
41,IBM,72,348,420,72,1029830,98678,100,986.78,244123.29636476727,66,60,81900,139812.5,128676.5,128132.0,134000.0
42,IBM,91,339,430,91,1473368,98678,100,986.78,309550.1964980801,92,91,126000,196400.0,98257.0,71575.0,130975.0
43,IBM,97,343,440,97,1612863,98678,100,986.78,333664.212427704,112,104,144000,241750.0,103407.0,81075.0,155875.0
44,IBM,101,349,450,101,1557951,98678,100,986.78,327162.6649099802,132,120,163800,272375.0,223876.5,198257.0,249125.0
45,IBM,101,359,460,101,1938083,98678,100,986.78,362117.1691911335,193,160,229370,391383.75,290602.5,238720.0,357685.0
46,IBM,108,362,470,108,1768327,98678,100,986.78,351202.0706758433,154,140,191100,316562.5,185700.0,124325.0,235825.0
47,IBM,92,388,480,92,1255463,98678,100,986.78,269175.233922068,110,98,136500,206936.0,103656.0,55137.5,124962.5
48,IBM,108,382,490,108,1505521,98678,100,986.78,307026.88476255623,154,136,191100,275200.0,94878.0,36150.0,112850.0
49,IBM,98,402,500,98,2223084,98678,100,986.78,400023.9236520736,269,232,330992,476095.0,331741.0,229794.0,409008.0
50,IBM,98,412,510,98,1500126,98678,100,986.78,309110.21283678093,92,91,126000,196400.0,0,0,0
51,IBM,106,414,520,106,1416993,98678,100,986.78,291221.2133602221,135,116,165496,247985.0,239343.0,230760.0,242236.0
52,IBM,110,420,530,110,2262349,98678,100,986.78,398073.23672033014,242,216,300300,458866.5,345960.0,294234.0,404097.0
53,IBM,111,429,540,111,1496550,98678,100,986.78,300095.6955872576,72,83,111900,156050.0,0,0,0
54,IBM,121,429,550,121,1876943,98678,100,986.78,338598.36812512844,165,267,186880,255851.25,193536.125,194704.875,237277.0
55,IBM,110,450,560,110,1781706,98678,100,986.78,343028.506762922,132,120,163800,279625.0,189051.5,149550.0,229700.0
56,IBM,120,450,570,120,1165545,98678,100,986.78,231875.88918859157,75,63,89000,153023.5,132224.0,121425.0,141867.0
57,IBM,121,459,580,121,2111656,98678,100,986.78,379195.852145036,154,139,191100,331062.5,219026.5,154425.0,265650.0
58,IBM,128,462,590,128,2130089,98678,100,986.78,382059.51943512674,198,179,245700,396252.0,137013.25,76725.0,195400.0
59,IBM,125,475,600,125,1906190,98678,100,986.78,359818.4308925823,176,159,218400,352224.0,262919.0,210639.0,307437.5
60,IBM,137,473,610,137,1460298,98678,100,986.78,295276.8195913794,33,56,54400,68487.5,36475.0,15775.0,41450.0
61,IBM,123,497,620,123,1858004,98678,100,986.78,338717.63740614394,154,139,191100,308196.0,200572.0,149875.0,246925.0
62,IBM,143,487,630,143,2590157,98678,100,986.78,442221.7518406348,144,170,223800,322100.0,218837.5,205000.0,280550.0
63,IBM,133,507,640,133,1684412,98678,100,986.78,317266.34022852156,167,145,206870,295075.0,207969.25,150627.0,250836.0
64,IBM,142,508,650,142,2334564,98678,100,986.78,395718.9811318128,198,180,245700,404937.5,345602.5,309165.0,375875.0
65,IBM,152,508,660,152,1326813,98678,100,986.78,254738.79290952135,48,56,74600,105700.0,34487.5,9812.5,38812.5
66,IBM,133,537,670,133,1909285,98678,100,986.78,353642.73558635416,96,112,149200,211400.0,202875.0,197425.0,207662.5
67,IBM,169,511,680,169,2225027,98678,100,986.78,386994.93939197704,176,159,218400,368000.0,324075.0,264125.0,344000.0
68,IBM,154,536,690,154,2468419,98678,100,986.78,407921.68996634637,198,179,245700,412187.5,185809.5,95700.0,238600.0
69,IBM,160,540,700,160,1687210,98678,100,986.78,301486.8174730033,134,144,161886,229368.0,16643.75,11250.0,52750.0
70,IBM,146,564,710,146,1850724,98678,100,986.78,343580.92233417154,132,120,163800,279625.0,0,0,0
71,IBM,165,555,720,165,2383764,98678,100,986.78,381298.23444385367,195,166,237000,425730.0,288193.5,219095.0,360200.0
72,IBM,164,566,730,164,1584179,98678,100,986.78,292359.47190573456,135,116,165496,247985.0,239208.0,234361.0,241217.0
73,IBM,153,587,740,153,2652940,98678,100,986.78,422739.7620451618,242,218,300300,484308.0,384325.0,327347.5,435437.5
74,IBM,158,592,750,158,2132270,98678,100,986.78,357526.9688261293,198,174,245700,368813.0,278882.0,240891.0,327647.0
75,IBM,178,582,760,178,2527070,98678,100,986.78,408310.51317104243,198,179,245700,412187.5,272246.0,197650.0,329950.0
76,IBM,170,600,770,170,2280408,98678,100,986.78,368678.56214594305,154,140,191100,323812.5,155397.0,89750.0,196525.0
77,IBM,159,621,780,159,3069598,98678,100,986.78,468907.6420639783,286,260,354900,581687.5,484937.5,432910.0,535187.5
78,IBM,167,623,790,167,2460697,98678,100,986.78,412854.9314383928,120,143,186500,271750.0,212112.5,197200.0,247425.0
79,IBM,192,608,800,192,3351316,98678,100,986.78,478512.6993779789,371,319,455114,676990.0,642465.5,586516.0,659851.0
80,IBM,181,629,810,181,1893487,98678,100,986.78,330212.4288106067,132,120,163800,272375.0,223876.5,198257.0,249125.0
81,IBM,172,648,820,172,2241306,98678,100,986.78,373321.414936245,234,203,289618,409130.0,193759.5,106762.5,247362.5
82,IBM,165,665,830,165,2612026,98678,100,986.78,411829.5951628537,242,215,300300,473047.5,310087.5,218125.0,365575.0
83,IBM,185,655,840,185,2535490,98678,100,986.78,415817.3496524646,163,169,234000,347450.0,325087.5,284075.0,330875.0
84,IBM,210,640,850,210,3162670,98678,100,986.78,471088.8434212808,223,208,288000,483500.0,389562.5,354687.5,437750.0
85,IBM,185,675,860,185,3269715,98678,100,986.78,477527.7461771201,242,218,300300,522312.5,514500.0,482750.0,514625.0
86,IBM,176,694,870,176,2857630,98678,100,986.78,437069.21552083717,286,255,354900,547453.5,432740.0,357018.0,491215.0
87,IBM,187,693,880,187,3385381,98678,100,986.78,486924.327688605,308,279,382200,625875.0,478675.0,419962.5,560287.5
88,IBM,194,696,890,194,3483108,98678,100,986.78,499613.166389758,286,258,354900,603437.5,423000.0,306625.0,504750.0
89,IBM,170,730,900,170,2705909,98678,100,986.78,414843.9895514939,286,250,354900,503310.0,441108.5,366823.0,467912.0
90,IBM,171,739,910,171,2471996,98678,100,986.78,393032.8502759025,156,143,198000,337450.0,274387.5,242212.5,303525.0
91,IBM,218,702,920,218,2824768,98678,100,986.78,443511.5020898556,144,170,223800,322100.0,234475.0,208075.0,289450.0
92,IBM,225,705,930,225,3912536,98678,100,986.78,522451.67539783043,440,377,537862,810920.0,582127.5,389179.0,734063.0
93,IBM,212,728,940,212,3022790,98678,100,986.78,457489.1039401922,190,208,288000,402800.0,243925.0,187812.5,307550.0
94,IBM,219,731,950,219,4084349,98678,100,986.78,540803.6717007384,330,298,409500,699062.5,387600.0,265375.0,501150.0
95,IBM,208,752,960,208,2924560,98678,100,986.78,435707.8198931022,242,220,300300,493312.5,394883.5,348489.0,446812.5
96,IBM,222,748,970,222,3086952,98678,100,986.78,447352.2738111432,335,290,413740,590150.0,486203.5,462982.0,562915.0
97,IBM,213,767,980,213,2967341,98678,100,986.78,441266.98945989605,264,238,327600,528336.0,253447.0,165000.0,338475.0
98,IBM,198,792,990,198,2721081,98678,100,986.78,398998.6348460355,198,180,245700,404937.5,345602.5,309165.0,375875.0
